data,codice_regione,denominazione_regione,ricoverati_con_sintomi,terapia_intensiva,totale_ospedalizzati,isolamento_domiciliare,totale_positivi,variazione_totale_positivi,nuovi_positivi,dimessi_guariti,deceduti,casi_da_sospetto_diagnostico,casi_da_screening,totale_casi,tamponi,casi_testati,ingressi_terapia_intensiva,note_test,note_casi,popolazione,totale_posti_terapia_intensiva,variazione_ricoverati_con_sintomi,variazione_terapia_intensiva,variazione_totale_ospedalizzati,posti_disponibili_terapia_intensiva,saturazione_terapia_intensiva,variazione_isolamento_domiciliare,variazione_nuovi_positivi,nuovi_tamponi,nuovi_casi_testati,nuovi_deceduti,nuovi_dimessi_guariti,np_su_nt,np_su_p,tc_su_p
2020-12-19T17:00:00,5,Veneto,2596,339,2935,94881,97816,-198,3834,109856,5382,,,213054,3104723,1159211.0,41.0,,,4907704,1016,-91,0,-91,677,33.37,-107,-377,22554,6792.0,114,3918,17.0,0.07812,4.34
2020-12-19T17:00:00,3,Lombardia,4495,592,5087,62566,67653,-557,1944,365440,24330,,,457423,4607391,2522230.0,14.0,,,10103969,1036,-161,-10,-171,444,57.14,-386,-800,27044,9517.0,105,2396,7.19,0.01924,4.53
2020-12-19T17:00:00,8,Emilia-Romagna,2819,206,3025,57924,60949,-1377,1641,85872,7023,,,153844,2412286,1176780.0,14.0,,,4467118,634,55,-1,54,428,32.49,-1431,-104,13851,4814.0,73,2944,11.85,0.03674,3.44
2020-12-19T17:00:00,12,Lazio,2773,306,3079,73510,76589,-570,1410,67945,3271,,,147805,2552084,1980503.0,14.0,,,5865544,847,-7,-4,-11,541,36.13,-559,-18,15052,7569.0,41,1939,9.37,0.02404,2.52
2020-12-19T17:00:00,16,Puglia,1432,177,1609,51780,53389,555,1382,24263,2156,,,79808,951771,616910.0,28.0,,,4008296,369,-25,3,-22,192,47.97,577,68,10848,4101.0,26,801,12.74,0.03448,1.99
2020-12-19T17:00:00,6,Friuli Venezia Giulia,594,55,649,12831,13480,-271,974,29645,1408,,,44533,864718,323999.0,2.0,,,1211357,180,-7,-4,-11,125,30.56,-260,221,10096,4865.0,9,1236,9.65,0.08041,3.68
2020-12-19T17:00:00,15,Campania,1598,122,1720,82470,84190,-507,949,92927,2560,,,179677,1893908,1278396.0,0.0,,,5785861,505,-23,2,-21,383,24.16,-486,-252,15739,11372.0,32,1424,6.03,0.0164,3.11
2020-12-19T17:00:00,19,Sicilia,1071,174,1245,32598,33843,-22,878,47763,2131,,,83737,1133274,759544.0,7.0,,,4968410,588,-20,-8,-28,414,29.59,6,147,7237,4412.0,22,878,12.13,0.01767,1.69
2020-12-19T17:00:00,1,Piemonte,3437,234,3671,34922,38593,-2707,638,142436,7499,,,188528,1606272,956072.0,1.0,,,4341375,575,-79,-9,-88,341,40.7,-2619,-572,10421,2410.0,38,3307,6.12,0.0147,4.34
2020-12-19T17:00:00,9,Toscana,998,189,1187,11839,13026,-493,540,98859,3415,,,115300,1780010,1026764.0,11.0,"Positivi diagnosticati solo con test antigenico rapido: in questo momento non è procedura adottatata da Regione Toscana, pertanto il valore è pari a zero",,3722729,523,-11,-2,-13,334,36.14,-480,26,11028,3976.0,25,1008,4.9,0.01451,3.1
2020-12-19T17:00:00,20,Sardegna,533,52,585,15091,15676,59,380,11746,653,,,28075,444991,372881.0,4.0,,"si segnalano i decessi dei seguenti pazienti:  - uomo, 85 anni, residente nella Provincia di Sassari; - donna, 76 anni, residente nella Città Metropolitana di Cagliari; - donna, 93 anni, residente nella Città Metropolitana di Cagliari; - donna, 97 anni, residente nella Città Metropolitana di Cagliari; - uomo, 74 anni, residente nella Provincia del Sud Sardegna; - uomo, 83 anni, residente nella Provincia del Sud Sardegna; - uomo, 86 anni, residente nella Provincia del Sud Sardegna; - donna, 94 anni, residente nella Provincia del Sud Sardegna; - donna, 76 anni, residente nella Provincia di Oristano.",1630474,180,-14,-1,-15,128,28.89,74,95,4068,3435.0,9,312,9.34,0.02331,1.72
2020-12-19T17:00:00,4,Trentino-Alto Adige,553,73,626,12547,13173,-430,378,33164,1526,0.0,0.0,47863,772164,305521.0,5.0,0,,1074819,106,0,0,0,33,68.87,-430,-42,5509,1059.0,12,796,6.86,0.03517,4.45
2020-12-19T17:00:00,11,Marche,416,65,481,9589,10070,-472,369,25358,1469,,,36897,482731,283895.0,6.0,,,1518400,143,-11,1,-10,78,45.45,-462,-12,5082,3460.0,10,831,7.26,0.0243,2.43
2020-12-19T17:00:00,7,Liguria,702,71,773,6324,7097,-369,271,47429,2766,,,57292,672431,311953.0,3.0,I 129339 test antigenici rapidi sono riferiti a partire dal 02/11/2020;  in Regione Liguria la positività al test antigenico rapido è seguita da conferma con test molecolare.,,1543127,209,-14,1,-13,138,33.97,-356,-16,4041,1167.0,12,628,6.71,0.01756,3.71
2020-12-19T17:00:00,10,Umbria,261,41,302,3663,3965,20,219,22604,559,,,27128,475045,243196.0,4.0,,,880285,117,-4,-2,-6,76,35.04,26,77,5158,1834.0,6,193,4.25,0.02488,3.08
2020-12-19T17:00:00,18,Calabria,290,21,311,8196,8507,4,207,11999,421,,,20927,412472,397452.0,3.0,,,1924701,239,-4,0,-4,218,8.79,8,-22,2609,2132.0,7,196,7.93,0.01075,1.09
2020-12-19T17:00:00,13,Abruzzo,565,43,608,12332,12940,-235,156,19195,1120,,,33255,484055,260727.0,2.0,,,1305770,148,6,1,7,105,29.05,-242,-71,3989,953.0,9,380,3.91,0.01195,2.55
2020-12-19T17:00:00,17,Basilicata,96,10,106,5870,5976,-61,66,3760,220,,,9956,173289,113196.0,0.0,,,556934,73,-3,0,-3,63,13.7,-58,-7,773,317.0,2,125,8.54,0.01185,1.79
2020-12-19T17:00:00,14,Molise,59,10,69,2671,2740,5,49,3060,172,,,5972,108221,99730.0,1.0,,,302265,34,2,1,3,24,29.41,2,-24,816,751.0,0,44,6.0,0.01621,1.98
2020-12-19T17:00:00,2,Valle d'Aosta,76,4,80,414,494,-6,23,6149,366,,,7009,59869,36240.0,0.0,,,125501,20,6,-3,3,16,20.0,-9,-1,270,176.0,1,28,8.52,0.01833,5.58
