data,codice_regione,denominazione_regione,ricoverati_con_sintomi,terapia_intensiva,totale_ospedalizzati,isolamento_domiciliare,totale_positivi,variazione_totale_positivi,nuovi_positivi,dimessi_guariti,deceduti,casi_da_sospetto_diagnostico,casi_da_screening,totale_casi,tamponi,casi_testati,ingressi_terapia_intensiva,note_test,note_casi,popolazione,totale_posti_terapia_intensiva,variazione_ricoverati_con_sintomi,variazione_terapia_intensiva,variazione_totale_ospedalizzati,posti_disponibili_terapia_intensiva,saturazione_terapia_intensiva,variazione_isolamento_domiciliare,variazione_nuovi_positivi,nuovi_tamponi,nuovi_casi_testati,nuovi_deceduti,nuovi_dimessi_guariti,np_su_nt,np_su_p,tc_su_p
2020-12-25T17:00:00,5,Veneto,2582,346,2928,84457,87385,-16637,5010,141454,5953,,,234792,3201904,1187079.0,36.0,,,4907704,1016,-48,-5,-53,670,34.06,-16584,1173,13776,3999.0,94,21553,36.37,0.10208,4.78
2020-12-25T17:00:00,3,Lombardia,3976,522,4498,54212,58710,802,2628,386391,24782,,,469883,4765500,2577061.0,20.0,,,10103969,1036,-202,1,-201,514,50.39,1003,-28,27942,9754.0,105,1721,9.41,0.02601,4.65
2020-12-25T17:00:00,8,Emilia-Romagna,2711,206,2917,56063,58980,1681,2127,96910,7400,,,163290,2496457,1204670.0,16.0,,,4467118,634,-7,5,-2,428,32.49,1683,435,10861,4546.0,65,381,19.58,0.04761,3.66
2020-12-25T17:00:00,12,Lazio,2666,290,2956,73118,76074,583,1691,76104,3489,,,155667,2635605,2016092.0,18.0,,,5865544,847,-24,-3,-27,557,34.24,610,172,16516,7002.0,31,1077,10.24,0.02883,2.65
2020-12-25T17:00:00,16,Puglia,1413,166,1579,52010,53589,458,1011,29775,2310,,,85674,1004403,635809.0,18.0,,,4008296,369,-9,-4,-13,203,44.99,471,-447,7540,1591.0,26,527,13.41,0.02522,2.14
2020-12-25T17:00:00,15,Campania,1449,102,1551,78996,80547,538,1009,102065,2670,,,185282,1983049,1329721.0,0.0,,,5785861,505,-39,0,-39,403,20.2,577,-147,16355,11689.0,7,464,6.17,0.01744,3.2
2020-12-25T17:00:00,1,Piemonte,3029,214,3243,28254,31497,-3373,875,154123,7755,,,193375,1648345,972116.0,7.0,,,4341375,575,-115,1,-114,361,37.22,-3259,-182,6080,2223.0,28,4220,14.39,0.02015,4.45
2020-12-25T17:00:00,19,Sicilia,995,174,1169,32063,33232,-148,720,53109,2256,,,88597,1179159,788040.0,15.0,,,4968410,588,-13,1,-12,414,29.59,-136,-133,6472,4215.0,17,851,11.12,0.01449,1.78
2020-12-25T17:00:00,9,Toscana,843,166,1009,10260,11269,300,613,103328,3558,,,118155,1841106,1047247.0,11.0,"Positivi diagnosticati solo con test antigenico rapido: in questo momento non è procedura adottatata da Regione Toscana, pertanto il valore è pari a zero",,3722729,523,-45,5,-40,357,31.74,340,50,11029,3806.0,6,307,5.56,0.01647,3.17
2020-12-25T17:00:00,11,Marche,398,60,458,9109,9567,152,603,28227,1516,,,39310,511362,303386.0,3.0,,,1518400,143,-11,-4,-15,83,41.96,167,188,6711,5062.0,12,439,8.99,0.03971,2.59
2020-12-25T17:00:00,6,Friuli Venezia Giulia,572,54,626,11458,12084,-18,584,33681,1534,,,47299,904549,334240.0,4.0,,,1211357,180,-10,-2,-12,126,30.0,-6,-247,5835,1541.0,20,582,10.01,0.04821,3.9
2020-12-25T17:00:00,7,Liguria,663,64,727,4942,5669,-289,445,50460,2842,,,58971,693519,317936.0,3.0,I 145443 test antigenici rapidi sono riferiti a partire dal 02/11/2020;  in Regione Liguria la positività al test antigenico rapido è seguita da conferma con test molecolare.,,1543127,209,-24,0,-24,145,30.62,-265,117,4130,1236.0,11,723,10.77,0.02884,3.82
2020-12-25T17:00:00,20,Sardegna,484,43,527,15793,16320,305,409,12855,701,,,29876,466701,391652.0,3.0,,Si segnalano i decessi dei pazienti:  - 1 uomo 89 aa residente nella Provincia del Sud Sardegna;  - 1 uomo 84 aa residente nella Provincia del Sud Sardegna;  - 1 decesso nella Provincia di Nuoro. ,1630474,180,-14,2,-12,137,23.89,317,78,3844,3301.0,3,101,10.64,0.02508,1.83
2020-12-25T17:00:00,13,Abruzzo,435,34,469,11398,11867,173,339,21408,1162,,,34437,505462,266505.0,2.0,Dal totale dei tamponi processati con test antigenici ne sono stati eliminati alcuni erroneamente conteggiati.,,1305770,148,-56,-1,-57,114,22.97,230,116,4309,1233.0,6,160,7.87,0.02596,2.64
2020-12-25T17:00:00,4,Trentino-Alto Adige,453,68,521,11820,12341,1488,336,35617,1603,0.0,0.0,49561,794650,311080.0,4.0,0,,1074819,106,-30,2,-28,38,64.15,1516,-44,5001,1748.0,12,-1164,6.72,0.03126,4.61
2020-12-25T17:00:00,18,Calabria,270,21,291,8238,8529,170,257,13308,441,,,22278,427662,409800.0,2.0,,,1924701,239,-14,0,-14,218,8.79,184,13,2203,2023.0,4,83,11.67,0.01335,1.16
2020-12-25T17:00:00,10,Umbria,240,36,276,3270,3546,25,232,23834,597,,,27977,490891,248275.0,3.0,,,880285,117,2,-2,0,81,30.77,25,40,2210,869.0,6,201,10.5,0.02636,3.18
2020-12-25T17:00:00,17,Basilicata,87,7,94,5862,5956,13,69,4251,240,,,10447,180476,116224.0,0.0,,,556934,73,-9,-1,-10,66,9.59,23,-86,853,364.0,5,51,8.09,0.01239,1.88
2020-12-25T17:00:00,14,Molise,52,7,59,2237,2296,30,68,3878,179,,,6353,112785,103607.0,0.0,,,302265,34,-1,0,-1,27,20.59,31,-47,566,472.0,1,37,12.01,0.0225,2.1
2020-12-25T17:00:00,2,Valle d'Aosta,84,4,88,340,428,1,11,6331,371,,,7130,61109,36873.0,0.0,,,125501,20,1,0,1,16,20.0,0,-24,101,33.0,0,10,10.89,0.00876,5.68
